6,6
X,0,2,H,2
A,1,0,H,2
B,3,0,H,2
C,1,1,H,2
D,3,1,V,2
E,4,1,H,2
F,2,2,V,2
G,5,2,V,2
H,0,3,H,2
I,3,3,H,2
J,0,4,V,2
K,2,4,V,2
L,4,4,H,2